%%%%%%%%%%%%%
%           %
%           %
%  G        %
%   PG      %
%           %
%        G  %
%         G %
%%%%%%%%%%%%%
