%%%%%%%%%%%%%
% GP        %
%           %
%        G  %
%           %
%  G        %
%           %
%     G     %
%%%%%%%%%%%%%
