%%%%%%%%%%%%%
%   %GGP    %
%   %     G %
%   %       %
%           %
%G          %
%%%%%%%%%%%%%
