%%%%%%%%%%%%%%%%%%%
%G.       G   ....%
%.% % %%%%%% %.%%.%
%.%o% %   o% %.o%.%
%.% %%%  %%%%%..%.%
%G....  P    %..%G%
%%%%%%%%%%%%%%%%%%%%
